0;3;2;0;0;64;64;1;0;0
0;4;2;64;0;64;64;1;0;1
0;5;2;0;64;64;64;0;0;2
0;6;2;64;64;64;64;0;0;3
0;7;2;128;0;64;64;1;5;4
0;8;2;128;64;64;64;1;4;5
0;9;2;0;128;64;64;0;3;6
0;10;2;64;128;64;64;0;6;7