0;5;2;0;0;64;64;1;0;0
0;9;2;0;0;64;64;1;0;0
0;5;3;0;0;64;64;1;0;0
0;9;3;0;0;64;64;1;0;0
0;5;4;0;0;64;64;1;0;0
0;9;4;0;0;64;64;1;0;0
0;5;5;0;0;64;64;1;0;0
0;9;5;0;0;64;64;1;0;0
0;2;6;64;0;64;64;1;0;1
0;7;6;0;128;64;64;0;3;6
0;12;6;64;0;64;64;1;0;1
0;3;7;64;0;64;64;1;0;1
0;4;7;64;0;64;64;1;0;1
0;10;7;64;0;64;64;1;0;1
0;11;7;64;0;64;64;1;0;1
0;5;8;64;0;64;64;1;0;1
0;6;8;64;0;64;64;1;0;1
0;7;8;64;0;64;64;1;0;1
0;8;8;64;0;64;64;1;0;1
0;9;8;64;0;64;64;1;0;1